NO textures/N.png
SO textures/S.png
WE textures/W.png
EA textures/E.png
DO textures/door.png

F 0, 255, 0
C 21, 96, 189

1111111111111111111111111
100000000011N000000000001
1011000001110000000000001
11111111101100000111000011111
10000000001100000111D11111111
1111D111111111011100000010001
11110111111111011101010010001
11000000110101011100000010001
10000000000000001100000010001
10000000000000001101010010001
11000001110101011111011110001
11110111 1110101 101111010001
11111111 1111111 111111111111