NO textures/N.png
SO textures/S.png
WE textures/W.png
EA textures/E.png
DO textures/door.png

F 220,100,0
C 225,30,0
1111111111111111111111111
1000000000110000000000001
1011000001110000000000001
10010000000000000000000011111
11111111101100000111000000001
10000000001100000111D11111111
11110111111111011100000010001
11110111111111011101010010001
11000000110101011100000010001
10000000000000001100E00010001
100000000D0000001101010010001
1100000111010101111101111000111
11110111 1110101 101111010001
11111111 1111111 111111111111