NO textures/N.png
SO textures/S.png
WE textures/W.png
EA textures/E.png



F 0, 0, 0
C 0, 0, 0

1111111111111111111
1000000000000000001
1000000000000001001
1011111111111000001
1010000000001111111
1010001000000000001
1011000001001001001
1000000000001000001
1111111111111111011
1E00000000000000001
1111111111111111111